###################
o   #           $ #
#   #           $ #
#   # !     #   $ #
#   #       #   $ #
#   #       #     _
#   #       #     #
#           #     #
#           #     #
###################

###################o   #           $ ##   #           $ ##   # !     #   $ ##   #       #   $ ##   #       #     _#   #       #     ##           #     ##           #     ####################